COINSSHOP : Münzen-Shop
FREE : KOSTENLOS
BUYTIPS : Tipps Kaufen
GETFREE : Kostenlos Erhalten
DAILYREWARD : Tägliche Belohnungen
DAY : Tag
THANKS : Danke!
LOADING : Lade...
LUCKYSPIN : <sprite index=0 color=#FE96CD>  GLÜCKSRAD  <sprite index=0 color=#FE96CD>
OK : OK
YOURWIN : Du Gewinnst!
NOADSLABEL1 : Mache diesen Kauf, um Werbung dauerhaft zu entfernen
NOADSLABEL2 : Belohnungsvideos sind optional und nach dem Kauf verfügbar
BUY : KAUFEN
OUTOFLIVES : KEINE LEBEN MEHR
REFILLTHELIVES : Leben auffüllen?
OUTOFTIME : KEINE ZEIT MEHR
REFILLTHETIME : Zeit auffüllen?
GIFT : Geschenk
LEVELCLEARED : LEVEL GESCHAFFT!
SETTINGS : Einstellungen
SHOP : SHOP
PRIVACY : DATENSCHUTZ
QUITTHEGAME : Spiel Beenden
DOYOUWANTTOQUIT : Möchtest du wirklich beenden?
YES : Ja
NO : NEIN
COMINGSOON : Starte das Spiel neu zum Spielen oder warte auf das nächste Update
YOUWIN : Du Gewinnst!
NEXTLEVEL : Nächstes Level
SCORE : Punktzahl
POINTS : Punkte
REVIVEWITHNEWSHAPES : Mit der Punktzahl fortfahren und neu beginnen?
WHATCHADS : Werbung Ansehen
CONTINUE : Weiter
YOULOSE : Du Verlierst...
RETRY : Wiederholen
ALMOST : Fast geschafft...
ARCADEMODE : ARKADE-MODUS
STAGE : STUFE {stage}
LEVEL : LEVEL {level}
MOSTPOPULAR : Am Beliebtesten
BESTOFFER : BESTES Angebot
NOADS : KEINE WERBUNG
FREESPIN : Kostenloser Spin
SOUNDS : Sounds
MUSIC : Musik
VIBRATION : Vibration
GAMEOVER : Spiel Vorbei
YOURSCORE : Deine Punktzahl
BESTSCORE : BESTE Punktzahl
NEWRECORD : Neuer Rekord!
EXITGAME : Spiel Beenden
ADVENTURE : ABENTEUER
CLASSIC : KLASSISCH
TUTORIAL : Tutorial
RESTORE_PURCHASES : KÄUFE WIEDERHERSTELLEN
TIMED : ZEITLIMIT
CONTINUEWITHEXTRASECONDS : EXTRA <color=yellow>+{continueTimerBonus}</color> sek
YOUHAVETIMELEFT : Du hast noch <color=yellow>{timeLeft}</color> min
CONTINUEORLOSEPROGRESS : Neue Formen oder Fortschritt verlieren?
LEADERBOARD : HEUTIGE BESTENLISTE
LANGUAGE : Sprache
RATEUS : Bewerte Uns
DELET_ACCOUNT : Konto Löschen
DELETE_ACCOUNT_TEXT : Bist du sicher, dass du dein Konto löschen möchtest?\nDies wird deinen Spielstand, Punktzahlen und alle verknüpften Daten dauerhaft löschen.\n[highlight]Diese Aktion ist nicht rückgängig zu machen.[/highlight]\nDu wirst von Google Play Games abgemeldet und deine Daten können nicht wiederhergestellt werden.\n\n\n[highlight]Um dein Konto dauerhaft zu löschen, gib bitte genau in das folgende Feld ein.[/highlight]
CANCEL : Abbrechen
DELETE : Löschen
ACCOUNT_DELETION_FAILED : Kontolöschung fehlgeschlagen, weil der eingegebene Wert nicht übereinstimmt.
HOLD_ON : Warte eine Sekunde vor dem Spielen!
HOLD_TEXT : Bevor du in ein lustiges Puzzle-Abenteuer eintauchst, hier ist etwas, das du wissen solltest!\nUm eine bessere Erfahrung zu bieten, kann dieses Spiel über Google Play Games, Werbung und Firebase-Analyse einige persönliche Daten sammeln.\nWeitere Details findest du in den folgenden Dokumenten:
VIEW_TERMS_OF_SERVICE : [ Nutzungsbedingungen Anzeigen ]
VIEW_PRIVACY_POLICY : [ Datenschutzrichtlinie Anzeigen ]
CONSENT_CHECKBOX : Ich habe gelesen und bin bereit für Puzzles!
AGREE : Zustimmen und Spielen Beginnen
CHECKBOX : Du musst das Kästchen aktivieren, um fortzufahren.
HOME : Hauptmenü
NOTHANKS : Ist okay. Ich mache es nochmal