COINSSHOP : Loja de Moedas
FREE : GRÁTIS
BUYTIPS : Comprar Dicas
GETFREE : Obter Grátis
DAILYREWARD : Recompensas Diárias
DAY : Dia
THANKS : Obrigado!
LOADING : Carregando...
LUCKYSPIN : <sprite index=0 color=#FE96CD>  RODA DA SORTE  <sprite index=0 color=#FE96CD>
OK : OK
YOURWIN : Você Venceu!
NOADSLABEL1 : Faça esta compra para remover anúncios permanentemente
NOADSLABEL2 : Vídeos de recompensa são opcionais e disponíveis após a compra
BUY : COMPRAR
OUTOFLIVES : SEM VIDAS
REFILLTHELIVES : Reabastecer as vidas?
OUTOFTIME : SEM TEMPO
REFILLTHETIME : Reabastecer o tempo?
GIFT : Presente
LEVELCLEARED : NÍVEL CONCLUÍDO!
SETTINGS : Configurações
SHOP : LOJA
PRIVACY : PRIVACIDADE
QUITTHEGAME : Sair do Jogo
DOYOUWANTTOQUIT : Você realmente quer sair?
YES : Sim
NO : NÃO
COMINGSOON : Reinicie o jogo para jogar novamente ou aguarde a próxima atualização
YOUWIN : Você Venceu!
NEXTLEVEL : Próximo Nível
SCORE : Pontuação
POINTS : Pontos
REVIVEWITHNEWSHAPES : Continuar com a pontuação e começar novamente?
WHATCHADS : Ver Anúncios
CONTINUE : Continuar
YOULOSE : Você Perdeu...
RETRY : Tentar Novamente
ALMOST : Quase lá...
ARCADEMODE : MODO ARCADE
STAGE : ESTÁGIO {stage}
LEVEL : NÍVEL {level}
MOSTPOPULAR : Mais Popular
BESTOFFER : MELHOR Oferta
NOADS : SEM ANÚNCIOS
FREESPIN : Giro Grátis
SOUNDS : Sons
MUSIC : Música
VIBRATION : Vibração
GAMEOVER : Fim de Jogo
YOURSCORE : Sua Pontuação
BESTSCORE : MELHOR Pontuação
NEWRECORD : Novo Recorde!
EXITGAME : Sair do Jogo
ADVENTURE : AVENTURA
CLASSIC : CLÁSSICO
TUTORIAL : Tutorial
RESTORE_PURCHASES : RESTAURAR COMPRAS
TIMED : TEMPO
CONTINUEWITHEXTRASECONDS : EXTRA <color=yellow>+{continueTimerBonus}</color> seg
YOUHAVETIMELEFT : Você tem <color=yellow>{timeLeft}</color> min restantes
CONTINUEORLOSEPROGRESS : Novas formas ou perder progresso?
LEADERBOARD : RANKING DE HOJE
LANGUAGE : Idioma
RATEUS : Avalie-nos
DELET_ACCOUNT : Excluir Conta
DELETE_ACCOUNT_TEXT : Tem certeza de que quer excluir sua conta?\nIsso excluirá permanentemente seu progresso no jogo, pontuações e quaisquer dados vinculados.\n[highlight]Esta ação é irreversível.[/highlight]\nVocê será desconectado do Google Play Games e seus dados não poderão ser recuperados.\n\n\n[highlight]Para excluir permanentemente sua conta, insira exatamente no campo a seguir.[/highlight]
CANCEL : Cancelar
DELETE : Excluir
ACCOUNT_DELETION_FAILED : A exclusão da conta falhou porque o valor inserido não corresponde.
HOLD_ON : Aguarde um segundo antes de jogar!
HOLD_TEXT : Antes de mergulhar em uma aventura divertida de quebra-cabeças, aqui está algo que você deve saber!\nPara fornecer uma experiência melhor, este jogo pode coletar alguns dados pessoais através do Google Play Games, anúncios e análise do Firebase.\nPara mais detalhes, consulte os documentos abaixo:
VIEW_TERMS_OF_SERVICE : [ Ver Termos de Serviço ]
VIEW_PRIVACY_POLICY : [ Ver Política de Privacidade ]
CONSENT_CHECKBOX : Li e estou pronto para resolver quebra-cabeças!
AGREE : Concordar e Começar a Jogar
CHECKBOX : Você precisa marcar a caixa para continuar.
HOME : Menu Principal
NOTHANKS : Tudo bem. Vou fazer de novo